10 10
0 0 0 0 S 7 1 0 0 0 0 0
0 0 0 0 p 0 0 0 0 0 
0 0 0 p p p 0 0 0 0
0 0 r r p r r 0 0 0
0 0 p r r r p 0 0 0
0 0 r p p p r 0 0 0
0 0 p r r r p 0 0 0
0 0 p p p p p 0 0 0
0 0 p p p p p d e 0
0 0 0 0 s 0 0 0 0 0
