10 10
s p p p p b 3 4 p 0 0 0
p p p r p p p 0 0 0
0 p p p p p p 0 0 0
0 p p 0 0 0 0 0 0 0
0 p p 0 0 0 0 0 0 0
0 p p d p 0 0 0 0 0
0 0 0 0 p 0 0 0 0 0
0 0 0 0 p p p p 0 0
0 0 0 0 0 p e p 0 0
0 0 0 0 0 p p p 0 0