10 10
0 p p p p p p 0 0 0
0 p p p p p e 0 0 0
0 p p p p p p 0 0 0
0 p p 0 0 0 0 0 0 0
0 p p 0 0 0 0 0 0 0
p p p p 0 0 0 0 0 0
0 p p p 0 0 0 0 0 0
0 p p p 0 0 0 0 0 0
0 p p p 0 0 0 0 0 0
0 s p p 0 0 0 0 0 0